# american\tbritish (lowercase; whole-word matching)
color	colour
colors	colours
colored	coloured
favorite	favourite
favorites	favourites
honor	honour
honors	honours
neighbor	neighbour
neighbors	neighbours
rumor	rumour
rumors	rumours
gray	grey
center	centre
defense	defence
offense	offence
armor	armour
traveler	traveller
travelers	travellers
traveling	travelling
traveled	travelled
canceling	cancelling
canceled	cancelled
catalog	catalogue
dialog	dialogue
